28,29,30,31,32,33,34,35,36,37,38,39,40,41,28,29,30,31,32,33,34,35,36,37,38,39,40,41,28,29,30,31,32,33,34,35,36,37,38,39,40,41,28,29,30,31,32,33,34,35,36,37,38,39,40,41,28,29,30,31,32,33,34,35,36,37,38,39,40,41,28,29,30,31,32,33,34,35,36,37
42,43,44,45,46,47,48,49,50,51,52,53,54,55,42,43,44,45,46,47,48,49,50,51,52,53,54,55,42,43,44,45,46,47,48,49,50,51,52,53,54,55,42,43,44,45,46,47,48,49,50,51,52,53,54,55,42,43,44,45,46,47,48,49,50,51,52,53,54,55,42,43,44,45,46,47,48,49,50,51
56,57,58,59,60,61,62,63,64,65,66,67,68,69,56,57,58,59,60,61,62,63,64,65,66,67,68,69,56,57,58,59,60,61,62,63,64,65,66,67,68,69,56,57,58,59,60,61,62,63,64,65,66,67,68,69,56,57,58,59,60,61,62,63,64,65,66,67,68,69,56,57,58,59,60,61,62,63,64,65
70,71,72,73,74,75,76,77,78,79,80,81,82,83,70,71,72,73,74,75,76,77,78,79,80,81,82,83,70,71,72,73,74,75,76,77,78,79,80,81,82,83,70,71,72,73,74,75,76,77,78,79,80,81,82,83,70,71,72,73,74,75,76,77,78,79,80,81,82,83,70,71,72,73,74,75,76,77,78,79
84,85,86,87,88,89,90,91,92,93,94,95,96,97,84,85,86,87,88,89,90,91,92,93,94,95,96,97,84,85,86,87,88,89,90,91,92,93,94,95,96,97,84,85,86,87,88,89,90,91,92,93,94,95,96,97,84,85,86,87,88,89,90,91,92,93,94,95,96,97,84,85,86,87,88,89,90,91,92,93
98,99,100,101,102,103,104,105,106,107,108,109,110,111,98,99,100,101,102,103,104,105,106,107,108,109,110,111,98,99,100,101,102,103,104,105,106,107,108,109,110,111,98,99,100,101,102,103,104,105,106,107,108,109,110,111,98,99,100,101,102,103,104,105,106,107,108,109,110,111,98,99,100,101,102,103,104,105,106,107
112,113,114,115,116,117,118,119,120,121,122,123,124,125,112,113,114,115,116,117,118,119,120,121,122,123,124,125,112,113,114,115,116,117,118,119,120,121,122,123,124,125,112,113,114,115,116,117,118,119,120,121,122,123,124,125,112,113,114,115,116,117,118,119,120,121,122,123,124,125,112,113,114,115,116,117,118,119,120,121
126,127,128,129,130,131,132,133,134,135,136,137,138,139,126,127,128,129,130,131,132,133,134,135,136,137,138,139,126,127,128,129,130,131,132,133,134,135,136,137,138,139,126,127,128,129,130,131,132,133,134,135,136,137,138,139,126,127,128,129,130,131,132,133,134,135,136,137,138,139,126,127,128,129,130,131,132,133,134,135
140,141,142,143,144,145,146,147,148,149,150,151,152,153,140,141,142,143,144,145,146,147,148,149,150,151,152,153,140,141,142,143,144,145,146,147,148,149,150,151,152,153,140,141,142,143,144,145,146,147,148,149,150,151,152,153,140,141,142,143,144,145,146,147,148,149,150,151,152,153,140,141,142,143,144,145,146,147,148,149
154,155,156,157,158,159,160,161,162,163,164,165,166,167,154,155,156,157,158,159,160,161,162,163,164,165,166,167,154,155,156,157,158,159,160,161,162,163,164,165,166,167,154,155,156,157,158,159,160,161,162,163,164,165,166,167,154,155,156,157,158,159,160,161,162,163,164,165,166,167,154,155,156,157,158,159,160,161,162,163
66,66,66,66,66,66,66,66,66,66,66,66,66,66,66,66,66,66,66,66,66,66,66,66,66,66,66,66,66,66,66,66,66,66,66,66,66,66,66,66,66,66,66,66,66,66,66,66,66,66,66,66,66,66,66,66,66,66,66,66,66,66,66,66,66,66,66,66,66,66,66,66,66,66,66,66,66,66,66,66
